1111111111111111111111111
1030010001111111122000311
1000110000000111100111111
1001100011100000000111111
1011111000000011111100001
1000011110110000111100001
1000000111100000011100111
1001100100001110001000001
1000110000011111001000001
1040110011111111111111101
1010100000000000000000001
1010001111111111111011111
1010101000000000000000101
1011101411010111110110001
1010100001110110000040101
1010111101000011111110101
1010000000011101000011101
1011011110000001100001001
1011010000100100110001011
1000010110101110000001001
1111111111111111111111111