1111111111111111111111111
1000000111000100040000001
1000011111111111100000001
1000000111111111111111001
1000111111000000000000001
1000000000000011111100001
1000000000000000000000001
1111111111111000000011111
1000000000000000000010301
1000000001111000000012221
1000000000000000000000001
1000111111111111111000001
1000000000100000011111111
1000000111111000000000041
1000000111100000000000001
1000000000000000000111111
1111111100000000000000001
1111111111111100011110011
1000000000000011110000001
1400011111100000000000001
1111111111111111111111111