1111111111111111111111111
1000000111111111111111111
1000011000010000000000011
1000111110010011100100011
1000100000010011000100111
1000000000110011100104001
1111100000010000000111111
1000000110000000111000001
1001111100010000001111001
1001110100010000000111001
1001100111111111000011001
1001000010401000000001041
1001100010001000000011001
1001110000011111000111001
1001111000000000001111001
1000001111100000000000001
1000010000100011111111001
1100010000000000011111111
1110000001110000011111111
1111111111110000022000031
1111111111111111111111111