1111111111111111111111111
1000000001130001110000001
1000111001111221110111101
1000000000000000000111001
1000111111111111111111101
1100000000011000000001101
1001111110011001001100001
1000011000011001000000011
1000011000000001000111001
1000011000111111000111001
1000000000110041110000001
1111111100110011001110001
1000000000000000000000111
1000011111111111111100001
1110011111111111111111101
1110011111100000000000001
1410000004100001110011001
1011111111100000000100011
1011111111101110111101111
1000000000000000100001111
1111111111111111111111111