1111111111111111111111111111111
1000301100000111022000311111111
1000001101110110011111111111111
1000000000110110001000111111111
1110110000110000001000011111111
1010100111100000001000011111111
1010100111001100001001111111111
1000110011011101111100011111111
1101111000011100001111011111111
1140011000000011100000011111111
1001011001100000011111411111111
1111011001100011011110011111111
1101000001100011000000111111111
1100000000000011011011111111111
1111100111100111011001111111111
1000000111110000001000011111111
1001000100010100100011011111111
1001111101010100110010011111111
1000011000010104011110111111111
1111000000010100000000111111111
1111111111111111111111111111111